1111111
10C0V01
10100E1
110C0C1
10CP001
1101C01
1111111