111111111111111
1PC00V0100010C1
10C00000101C011
111C000C001C0C1
110CVC000010001
1C0C01C1C0C1001
10CC10C000C0C11
10010CC00101111
10V01001011C001
10C01V100011001
100C1010010V001
100000110100101
1100V0000C00001
100011C0V000CE1
111111111111111