111111
10P101
10C001
110E01
111111