11111111111111111111
10000010001000000001
1001010011100V000011
10001000000001000001
100101C0010000010C01
10000010010000010111
11000100101100000011
11100011000001010011
10001000001101001001
100000000111V0001001
10000100001010001011
10001010000000110001
1110000110P000000001
1100100011000100C001
10101001011100011101
10000000000000000111
110C0011101000100011
10010100100100000111
100001100010000000E1
11111111111111111111