111111111111111111111111111111111111111111111111111111111
110001001011000000111000100101100000011100010010110000001
10000010000000P000000000010001000000001000001000100000001
1001010011100V000010001010010000V000000001010000000V00001
100010000000010000000001000000001000001000100000000100001
100101C0010000010C0100101C0010000010C0100101C0000000010C1
100000100100000101110000010010000010111000001000000001011
110001001000000000111000100101100000011100010010010000001
110001001011000000111000100101100000011100010010010000001
100000100010000000000000000001000000001000001000000000001
1001010011100V000010001010000000V000000001010011100V00001
100010000000010000000001000000001000000000000000000100001
100101C0010000010C0100101C0000000010C0000101C0010000010C1
100000100100000101110000010000000010000000001001000001011
110001001011000000111000100100000000011100010010000000001
110001001011000000111000000100000000000000010010110000001
100000100010000000000000000001000000001000001000100000001
1001010011100V000010001010000000V000000001010000000V00001
100010000000010000000001000000001000001000100000000100001
100101C00100E0010C0100101C0010000010C0000101C0000000010C1
100000100100000101110000010010000010110000001000000001011
110001001011000000111000100101100000011100010010000000001
111111111111111111111111111111111111111111111111111111111