1111111
111P111

11C11E1
1111111