1000000000001
1000C0111C001
1111111111111222
